id	bigint(20) unsigned	NO	NULL
file_id	bigint(20) unsigned	YES	NULL
name	varchar(255)	NO	NULL
shift_id	bigint(20) unsigned	NO	NULL
user_id	bigint(20) unsigned	NO	NULL
doctor_id	bigint(20) unsigned	YES	NULL
phone	varchar(10)	NO	NULL
gender	varchar(255)	NO	NULL
age_day	int(11)	YES	NULL
age_month	int(11)	YES	NULL
age_year	int(11)	YES	NULL
company_id	bigint(20) unsigned	YES	NULL
subcompany_id	bigint(20) unsigned	YES	NULL
company_relation_id	bigint(20) unsigned	YES	NULL
paper_fees	int(11)	YES	NULL
guarantor	varchar(255)	YES	NULL
expire_date	date	YES	NULL
insurance_no	varchar(255)	YES	NULL
is_lab_paid	tinyint(1)	NO	0
lab_paid	int(11)	NO	0
result_is_locked	tinyint(1)	NO	0
sample_collected	tinyint(1)	NO	0
sample_collect_time	time	YES	NULL
result_print_date	datetime	YES	NULL
result_url	text	YES	NULL
sample_print_date	datetime	YES	NULL
visit_number	int(11)	NO	NULL
result_auth	tinyint(1)	NO	NULL
result_auth_user	bigint(20) unsigned	YES	NULL
auth_date	timestamp	YES	NULL
created_at	timestamp	YES	NULL
updated_at	timestamp	YES	NULL
country_id	bigint(20) unsigned	YES	NULL
gov_id	varchar(255)	YES	NULL
address	text	YES	NULL
discount	double	NO	0
doctor_finish	tinyint(1)	NO	0
doctor_lab_request_confirm	tinyint(1)	NO	0
doctor_lab_urgent_confirm	tinyint(1)	NO	0
referred	varchar(255)	NO	NULL
discount_comment	varchar(255)	NO	NULL
